opplæring	opettaminen
sørsamisk	eteläsaame
tidsperspektiv	aikaperspektiivi
sameting	saametinka
samelov	saamelaki
lulesamisk	luulajansaame
språkregel	kielireekeli
forvaltningsområde	hallintoalue
befolkning	väestö
nordsamisk	pohjaissaame
inkluderingsdepartement	inkluderingsdepartementti
kunnskapsdepartement	kunnskapsdepartementti
rekruttering	rekrytointi
læreplan	opetusplaana
omsorg	välittäminen
middel	väline
læremiddel	opetusmateriaali
innsats	panos
samiskopplæring	saamenopettaminen
tilsyn	tilsyn	+?
kartlegging	kartoittaminen
forvaltning	hallinto
førstespråk	ensimäinenkieli
studie	tutkielma
forskrift	määräys
terminologi	terminologia
oppfølging	seuranta
lokalsamfunn	paikalissamfynni
etat	etaatti
utdanningsdirektorat	koulutusdirektoraatti
undersøkelse	tutkimus
lærerutdanning	opettaajakoulutus
kriminalomsorg	kriminaalihoito
urfolk	alkupöräiskansa
tolketjeneste	tulkkipalvelu
skilting	kyltittäminen
register	rekisteri
videreutdanning	jatkokoulutus
personell	persunaali
helsetjeneste	terveyspalvelu
foretak	yritys
barnehagetilbud	lastentarastarjous
utredning	selvitys
språkopplæring	kielenopetus
evaluering	evalueerinki
språkbruker	kielenkäyttääjä
planperiode	plaanaperioodi
opplæringslov	opetuslaki
høgskole	korkkeekoulu
hensyn	huoli
barnevern	lastensuojelu
tospråklighet	kaksikielisyys
tilgang	pääsy
tegnsett	merkistö
tannhelse	hammastervheys
språkområde	kieliala
politihøgskole	poliisikorkkeekoulu
oppdrag	tehtävä
håndbok	käsikirja
grunnopplæring	peruskoulutus
grunnopplæring	perusopetus
gjennomføring	läpivieminen
andrespråk	toinen kieli
sameloven	saamelaislaki
pakt	pakti
omsorgstjeneste	hoitopalvelu
læring	oppiminen
konvensjon	konvensuuni
inkludering	sisälyttäminen
inkludere	V	sisälyttäät
hageeier	haakinomistaaja
fjernundervisning	kauko-opetus
barnehageeier	lastentarhaanomistaaja
voksenopplæring	raavhaittenkoulutus
velferdsetat	hyvinvointietaatti
språkutvikling	kieleneistys
språkskifte	kielenvaihetus
skoleår	kouluvuosi
samepolitikk	saamelaispolitikki
materiell	A	materiaalinen
kymrisk	kymri
kulturkompetanse	kulttuurikompetanssi
konsultasjon	konsultasuuni
hjemmespråk	kotikieli
helsepersonell	hoitopersunaali
grendeskole	kyläkoulu
etablering	etableeraus
dialog	dialoogi
analysegruppe	analyysijoukko
veg	tie
vedtaksorgan	päätösorgaani
tjenestetilbud	palvelutarjous
tilknytning	yhtheys
stortingsmelding	isotinkamellinki
språkteknologi	kieliteknologii
språkmiljø	kielimiljöö
sekretariat	sekretariaatti
samtale	keskustelu
politidepartement	poliisidepartementti
oversetting	kääntäminen
overgang	siirtyminen
østsamisk	öystäsaame
metode	metoodi
kulturforståelse	kulttuurinymmärys
krets	piiri
konfliktråd	konfliktråd	+?
justis	justis	+?
hoved	hoved	+?
gir	vaihde
forutsetning	edellytys
finansiering	rahoittaminen
finansiering	rahoitus
får	får	+?
deltakelse	deltakelse	+?
avisside	avisside	+?
arbeidsgruppe	työryhmä
vesen	olio
tilrettelegging	tilrettelegging	+?
tilpasning	soveltaminen
tilpasning	sovellus
talesyntese	talesyntese	+?
synliggjøring	synliggjøring	+?
studietilbud	studietilbud	+?
språksamfunn	språksamfunn	+?
språkleir	språkleir	+?
språkgruppe	kieliryhmä
språkarbeid	språkarbeid	+?
soning	soning	+?
skoltesamisk	koltansaamelainen
skjema	lomake
sidemål	sidemål	+?
satsing	satsing	+?
samfunnsområde	samfunnsområde	+?
samfunnsliv	yhteiskuntaelämä
rekrutteringstiltak	rekrutteringstiltak	+?
produksjon	tuotanto
omfang	omfang	+?
navnekonsulent	navnekonsulent	+?
liturgi	liturgi	+?
likestillingsdepartement	likestillingsdepartement	+?
kontinuitet	jatkuvuus
kommunikasjonsspråk	kommunikasjonsspråk	+?
irsk	irsk	+?
innspill	innspill	+?
initiativ	aloite
henvendelse	henvendelse	+?
forpliktelse	velvoite
forpliktelse	sitoutuminen
brukerundersøkelse	brukerundersøkelse	+?
bidrag	bidrag	+?
behandling	kohtelu
behandling	käsittely
behandling	hoito
aspirant	aspirant	+?
3	3	+?
video	video
vedtak	päätös
utviklingsarbeid	kehitystyö
tolkeutdanning	tolkeutdanning	+?
tiltaksdel	tiltaksdel	+?
tilskuddsordning	tilskuddsordning	+?
studieforbund	studieforbund	+?
språkreirbarnehage	språkreirbarnehage	+?
skrivemåte	kirjoitustapa
skoleeier	skoleeier	+?
skatteetat	skatteetat	+?
samsvar	samsvar	+?
samiskundervisning	samiskundervisning	+?
samhandlingsspråk	samhandlingsspråk	+?
samfunnsarena	samfunnsarena	+?
samarbeidsavtale	yhteistyösopimus
rutine	rutiini
revisjon	tilintarkastus
ressurssenter	ressurssenter	+?
rekrutteringsgrunnlag	rekrutteringsgrunnlag	+?
publikasjon	julkaisu
programvare	softa
programvare	ohjelmisto
pitesamisk	piitimensaame
opprettelse	opprettelse	+?
opplæringsbehov	opplæringsbehov	+?
opplære	opplære	+?
nødmeldetjeneste	nødmeldetjeneste	+?
nemnd	nemnd	+?
mill	mill	+?
majoritetsspråk	majoritetsspråk	+?
kompetanseutvikling	kompetanseutvikling	+?
kirkeråd	kirkkoneuvosto
kirkeliv	kirkeliv	+?
justisdepartement	oikeusministeriö
innkjøpsordning	innkjøpsordning	+?
innføring	perehtyminen
informasjonsmateriale	informasjonsmateriale	+?
holdning	asenne
handling	tekeminen
godkjenningsordning	godkjenningsordning	+?
fritak	fritak	+?
fond	rahasto
fond	säätiö
faktor	kerroin
fagfolk	fagfolk	+?
europaråd	europaråd	+?
bevissthet	tietoisuus
bevaring	bevaring	+?
avgrensning	avgrensning	+?
§ 6	§ 6	+?
4	4	+?
2	2	+?
12	12	+?
voksenopplæringsprogram	voksenopplæringsprogram	+?
virkeperiode	virkeperiode	+?
versjon	versio
verneplikt	asevelvollisuus
velferdsforvaltning	velferdsforvaltning	+?
utviklingsprosjekt	kehittämishanke
utgang	uloskäynti
utforming	muotoilu
utdanningstilbud	utdanningstilbud	+?
utdanne	kouluttaa
utarbeidelse	utarbeidelse	+?
trosopplæring	trosopplæring	+?
timetall	timetall	+?
tilstedeværelse	tilstedeværelse	+?
tilgjengelighet	saavutettavuus
terminologiutvikling	terminologiutvikling	+?
teknologi	teknologia
studiepoeng	opintopiste
studielån	studielån	+?
stede	stede	+?
stavekontroll	stavekontroll	+?
st. meld. nr	st. meld. nr	+?
språkundersøkelse	språkundersøkelse	+?
språkstyre	språkstyre	+?
språkstimulering	språkstimulering	+?
språkrevitalisering	språkrevitalisering	+?
språkpolitikk	språkpolitikk	+?
språkkompetanse	språkkompetanse	+?
språkarena	språkarena	+?
sosialtjeneste	sosiaalipalvelu
sosialsektor	sosialsektor	+?
skattyter	skattyter	+?
siida	siida	+?
servicesenter	servicesenter	+?
sender	lähetin
rekrutteringskampanje	rekrutteringskampanje	+?
regionaldepartement	regionaldepartement	+?
regi	ohjaus
regelverk	säännöstö
referanse	viite
rådgivning	rådgivning	+?
pressestøtte	pressestøtte	+?
posisjon	asema
polititjenestemann	poliisivirkailija
pitesame	pitesame	+?
osv	osv	+?
opplæringstilbud	opplæringstilbud	+?
oppdragsdokument	oppdragsdokument	+?
oppdatering	päivitys
økning	lisääntyminen
nr	nr	+?
nedleggelse	lakkautus
nære	nære	+?
minoritetsspråkpakt	minoritetsspråkpakt	+?
minoritetsbakgrunn	minoritetsbakgrunn	+?
medarbeider	työntekijä
målgruppe	kohderyhmä
lovgivning	lainsäädäntö
lensmannsetat	lensmannsetat	+?
lærling	oppilas
lærling	oppipoika
kunstner	taiteilija
kunstner	taitelija
kunnskapsutvikling	kunnskapsutvikling	+?
kriterium	kriteeri
kostnad	kulu
korrekturprogram	korrekturprogram	+?
komité	komitea
komité	lautakunta
kole	kole	+?
informasjonsmøte	informasjonsmøte	+?
hovedmål	päätavoite
hovedårsak	hovedårsak	+?
heng	heng	+?
helseforskning	helseforskning	+?
handle	kaupitella
grunnopplæringstilbud	grunnopplæringstilbud	+?
gange	gange	+?
funn	löydös
funn	löytäminen
funn	löytö
friomsorg	friomsorg	+?
fremtid	tulevaisuus
frafall	frafall	+?
førstegangstjeneste	førstegangstjeneste	+?
førskolelærer	førskolelærer	+?
forskningskompetanse	forskningskompetanse	+?
føring	føring	+?
fordeling	jakautuminen
fordeling	jakauma
flertall	enemmistö
flertall	monikko
erklæring	julistus
element	elementti
eldreomsorg	eldreomsorg	+?
drømmejobb	drømmejobb	+?
bibliotektilbud	bibliotektilbud	+?
bibelselskap	bibelselskap	+?
betjent	betjent	+?
barnehagelov	barnehagelov	+?
anbefaling	suositus
ytelse	suoritus
voks	voks	+?
virkemiddel	virkemiddel	+?
vikling	vikling	+?
utviklingstiltak	utviklingstiltak	+?
utvidelse	laajennus
utvidelse	laajentaminen
utvalg	valikoima
utvalg	valiokunta
uttrykk	ilmaiseminen
uttrykk	ilmaisu
uttrykk	ilmaus
utredningssenter	utredningssenter	+?
utdanningspermisjon	utdanningspermisjon	+?
utarbeiding	utarbeiding	+?
urfolksspråk	urfolksspråk	+?
ungdomstrinn	ungdomstrinn	+?
ungdomsorganisasjon	nuorisojärjestö
undervisningsspråk	undervisningsspråk	+?
tolking	tulkinta
timefordeling	timefordeling	+?
tilråding	neuvonta
tilhørighet	kuuluisuus
telling	telling	+?
taleteknologi	taleteknologi	+?
styringsdialog	styringsdialog	+?
studieplass	studieplass	+?
strekk	strekk	+?
stedsnavntjeneste	stedsnavntjeneste	+?
språkvalg	språkvalg	+?
språkutviklingstiltak	språkutviklingstiltak	+?
språktiltak	språktiltak	+?
språksituasjon	språksituasjon	+?
språkkapittel	språkkapittel	+?
spesialisthelsetjeneste	spesialisthelsetjeneste	+?
sørsame	sørsame	+?
søknadsskjema	søknadsskjema	+?
søkelys	søkelys	+?
skolestruktur	skolestruktur	+?
skolestart	skolestart	+?
skoleledelse	skoleledelse	+?
skolehelsetjeneste	skolehelsetjeneste	+?
selvangivelse	veroilmoitus
satsning	satsning	+?
samordning	samordning	+?
samisk-norsk	samisk-norsk	+?
rus	humala
rettskrivingsverktøy	rettskrivingsverktøy	+?
ressursskole	ressursskole	+?
representasjon	edustus
redaksjon	toimituskunta
redaksjon	toimitus
publisering	publisering	+?
problemstilling	problemstilling	+?
pr	pr	+?
politiutdanning	politiutdanning	+?
politietat	politietat	+?
politidistrikt	politidistrikt	+?
plassering	sijainti
pilotprosjekt	pilotprosjekt	+?
øvingsvirksomhet	øvingsvirksomhet	+?
oversikt	oversikt	+?
overføringsverdi	overføringsverdi	+?
østsame	østsame	+?
øremerke	øremerke	+?
opplegg	opplegg	+?
omlegging	omlegging	+?
navnetjeneste	navnetjeneste	+?
navnesak	navnesak	+?
nærvær	läsnäolo
nærhet	läheisyys
musikktradisjon	musikktradisjon	+?
møtested	kohtaamispaikka
misnøye	misnøye	+?
medvirkning	myötävaikutus
målsetting	tavoite
målsetning	målsetning	+?
majoritet	majoritet	+?
lovverk	lovverk	+?
lokale	lokale	+?
likeverdighet	likeverdighet	+?
leseferdighet	lukutaito
læremiddelutvikling	læremiddelutvikling	+?
kvalitetssikring	kvalitetssikring	+?
kulturarv	kulttuuriperintö
kr	kr	+?
konsekvensanalyse	konsekvensanalyse	+?
kon	kartio
kompetansesenter	kompetansesenter	+?
klassetrinn	klassetrinn	+?
kjerneområde	ydinalue
kap	kap	+?
kampanje	kampanja
ire	irlantilainen
ire	iiri
instans	instans	+?
informasjonstiltak	informasjonstiltak	+?
informasjonsmateriell	informasjonsmateriell	+?
identifisering	identifisering	+?
hovedspråk	pääkieli
hovedspråk	valtakieli
hovedfokus	hovedfokus	+?
hjemmel	oikeus
hhv	hhv	+?
henhold	henhold	+?
helsevern	helsevern	+?
helsetreff	helsetreff	+?
helsestasjon	helsestasjon	+?
halvpart	puolikas
halvår	halvår	+?
grunnutdanning	grunnutdanning	+?
grunnskoleopplæring	grunnskoleopplæring	+?
grunnskolealder	grunnskolealder	+?
gode	gode	+?
gjøring	gjøring	+?
fylkesveg	fylkesveg	+?
framgang	framgang	+?
fraflytting	fraflytting	+?
forvaltningsterm	forvaltningsterm	+?
forskningsråd	forskningsråd	+?
forskningsprogram	forskningsprogram	+?
forprosjekt	forprosjekt	+?
fornying	fornying	+?
folketelling	väestölaskenta
folketelling	väestönlaskenta
folkeregister	väestörekisteri
folkegruppe	väestöryhmä
folkegruppe	kansakunta
folkegruppe	kansanryhmä
fjernsyn	televisio
finnmarksklinikk	finnmarksklinikk	+?
filmsenter	filmsenter	+?
festing	festing	+?
fengselspersonale	fengselspersonale	+?
fagområde	erikoisala
fagdag	fagdag	+?
f.eks	f.eks	+?
evalueringsrapport	evalueringsrapport	+?
ettergivelse	ettergivelse	+?
etc	etc	+?
enkeltperson	enkeltperson	+?
enkeltmenneske	enkeltmenneske	+?
enighet	yksimielisyys
elevtall	elevtall	+?
duodjikurs	duodjikurs	+?
domene	toimialue
disposisjon	jäsennys
datalingvistikk	tietokonelingvistiikka
dagpenger	dagpenger	+?
dagens	dagens	+?
bruksspråk	bruksspråk	+?
bro	bro	+?
bidragsyter	bidragsyter	+?
bibeloversettelse	raamatun-käännös
bevisstgjøring	bevisstgjøring	+?
bevilgning	bevilgning	+?
begrunnelse	peruste
begrunnelse	perustelu
begrep	käsitys
begrep	käsite
bedrift	yritys
basis	alusta
barnehagesektor	barnehagesektor	+?
barnehagebevegelse	barnehagebevegelse	+?
autorisasjon	autorisasjon	+?
arbeidsoppgave	työtehtävä
arbeidsoppgave	pesti
ansvarsområde	vastuualue
analyse	analyysi
analfabetisme	analfabetisme	+?
alfabetiseringsprosjekt	alfabetiseringsprosjekt	+?
alfabetisering	alfabetisering	+?
IT	IT	+?
§ 1	§ 1	+?
9	9	+?
8	8	+?
66	66	+?
65	65	+?
64	64	+?
63	63	+?
62	62	+?
61	61	+?
60	60	+?
59	59	+?
58	58	+?
57	57	+?
55	55	+?
54	54	+?
53	53	+?
52	52	+?
51	51	+?
5	5	+?
49	49	+?
47	47	+?
46	46	+?
45	45	+?
44	44	+?
43	43	+?
42	42	+?
41	41	+?
40	40	+?
39	39	+?
38	38	+?
37	37	+?
36	36	+?
34	34	+?
33	33	+?
32	32	+?
30	30	+?
28	28	+?
26	26	+?
25	25	+?
24	24	+?
22	22	+?
20	20	+?
19	19	+?
18	18	+?
15	15	+?
14	14	+?
13	13	+?
yting	yting	+?
yrkesgruppe	yrkesgruppe	+?
www	www	+?
vitenskapsspråk	vitenskapsspråk	+?
vitenskap	tiede
vitalisering	vitalisering	+?
viser	viisari
viktighet	tärkeys
vigsel	vigsel	+?
videreutvikling	videreutvikling	+?
videreutdanningstilbud	videreutdanningstilbud	+?
videreføring	videreføring	+?
veterinærhøgskole	veterinærhøgskole	+?
velferdstjeneste	velferdstjeneste	+?
velferdsoppgave	velferdsoppgave	+?
velferdsdirektorat	velferdsdirektorat	+?
veiledningstilbud	veiledningstilbud	+?
vedtekt	vedtekt	+?
vedlikehold	ylläpitää
varetakelse	varetakelse	+?
vanske	vanske	+?
vaktordning	vaktordning	+?
utviklingssenter	utviklingssenter	+?
utviklingsprosess	utviklingsprosess	+?
utviklingsmulighet	kehitysmahdollisuus
uttelling	uttelling	+?
utsendelse	utsendelse	+?
utredningsarbeid	utredningsarbeid	+?
utøver	harjoittaja
utøvelse	harjoitus
utlysning	utlysning	+?
utjevning	utjevning	+?
utgave	utgave	+?
utdanningssenter	koulutuskeskus
utdanningssenter	opastuskeskus
utdannelse	utdannelse	+?
utbredelse	leviäminen
utbredelse	esiintyvyys
utbetaling	maksaminen
universitetssykehus	universitetssykehus	+?
ungdomsprogram	ungdomsprogram	+?
undervisningstilbud	undervisningstilbud	+?
understøtte	understøtte	+?
underkontor	underkontor	+?
underkant	underkant	+?
umesamisk	umesamisk	+?
tvistelov	tvistelov	+?
tv	tv	+?
trygdeytelse	trygdeytelse	+?
trosopplæringsreform	trosopplæringsreform	+?
trivsel	viihtyvyys
treffsted	treffsted	+?
tolkning	tolkning	+?
tolkehjelp	tolkehjelp	+?
tolkeautorisasjon	tolkeautorisasjon	+?
tjenesteyting	palvelus
timeplan	aikataulu
timeplan	lukujärjestys
tilvekst	tilvekst	+?
tiltaksplan	tiltaksplan	+?
tilsynsmetodikk	tilsynsmetodikk	+?
tilskuddsmiddel	tilskuddsmiddel	+?
tilpassing	sopeutuminen
tilpassing	mukaelma
tilnærming	lähentely
tilleggsverktøy	tilleggsverktøy	+?
tildelingskriterium	tildelingskriterium	+?
tildeling	tildeling	+?
tilbakegang	taantuminen
tilbakeføring	tilbakeføring	+?
tet	kärki
tet	johto
terminologiliste	terminologiliste	+?
terminologiarbeid	terminologiarbeid	+?
termgruppe	termgruppe	+?
tematikk	tematikk	+?
temaområde	temaområde	+?
temahefte	temahefte	+?
tekstbehandling	tekstinkäsittely
teatertilbud	teatertilbud	+?
team	team	+?
tannvern	tannvern	+?
tannhelseforhold	tannhelseforhold	+?
talespråk	puhekieli
taleprogram	taleprogram	+?
t.d	t.d	+?
synergieffekt	synergieffekt	+?
sykehjem	sykehjem	+?
suksess	menestys
suksess	onnistuminen
suksess	yleisömenestys
studiesenter	studiesenter	+?
studieretning	studieretning	+?
straffesak	rikosasia
straffegjennomføring	straffegjennomføring	+?
stipendordning	stipendordning	+?
stipendiat	stipendiat	+?
stimuleringstiltak	stimuleringstiltak	+?
stimulering	stimulering	+?
stedsnavnsregister	stedsnavnsregister	+?
stedsnavnskonsulent	stedsnavnskonsulent	+?
stedsnavnskilt	stedsnavnskilt	+?
statusrapport	statusrapport	+?
statstilskudd	statstilskudd	+?
statsbudsjett	valtiontalous
stas	stas	+?
start	start	+?
stadium	stadium	+?
spredning	levitys
språkverktøy	språkverktøy	+?
språkrøkt	kielenhuolto
språkprogram	språkprogram	+?
språkorgan	språkorgan	+?
språkmotivering	språkmotivering	+?
språkmelding	språkmelding	+?
språkmedarbeider	kielityöntekijä
språkkurs	språkkurs	+?
språkkonferanse	språkkonferanse	+?
språkgrense	språkgrense	+?
språkforståelse	språkforståelse	+?
språkfolk	språkfolk	+?
språkfag	språkfag	+?
språkbestemmelse	språkbestemmelse	+?
språkbarriere	språkbarriere	+?
språkbærer	språkbærer	+?
sosialtjenestelov	sosialtjenestelov	+?
sosialspørsmål	sosialspørsmål	+?
sosialprosjekt	sosialprosjekt	+?
sosialpersonell	sosialpersonell	+?
sosialinstitusjon	sosialinstitusjon	+?
sosialfag	sosialfag	+?
søkning	søkning	+?
slig	malmirikaste
skriveprosess	skriveprosess	+?
skotsk	skotlantilainen
skolesystem	koulujärjestelmä
skolefag	kouluaine
skatteyter	skatteyter	+?
sjanse	mahdollisuus
sikt	sikt	+?
sideprosjekt	sideprosjekt	+?
sesjon	sesjon	+?
service	ylläpito
selvstyre	itsehallinto
selvforståelse	selvforståelse	+?
selskap	selskap	+?
sektorområde	sektorområde	+?
sektoransvarsprinsipp	sektoransvarsprinsipp	+?
seer	seer	+?
scenespråk	scenespråk	+?
satsingsområde	satsingsområde	+?
samvær	kanssakäyminen
samvær	yhdessäolo
samråd	samråd	+?
samordningsansvar	samordningsansvar	+?
samiskkunnskap	samiskkunnskap	+?
samiskkompetanse	samiskkompetanse	+?
samhandlingsreform	samhandlingsreform	+?
samfunnsstraff	samfunnsstraff	+?
samfunnsforhold	samfunnsforhold	+?
sametingspresident	sametingspresident	+?
samefolk	samefolk	+?
samarbeidsprosjekt	yhteistyöhanke
samarbeidspartner	yhteistyökumppani
saksbehandling	asiankäsittely
saksbehandlerprogram	saksbehandlerprogram	+?
s	s	+?
rypefangst	rypefangst	+?
rusomsorg	rusomsorg	+?
rusmiddel	päihde
rusbehandling	rusbehandling	+?
roll	roll	+?
riksveg	riksveg	+?
riksgrense	riksgrense	+?
revitaliseringsprosjekt	revitaliseringsprosjekt	+?
revitalisere	elvyttää
retur	palauttaminen
retur	palautus
retur	paluu
rettsvesen	rettsvesen	+?
rettssikkerhet	rettssikkerhet	+?
rettskriving	rettskriving	+?
rettsforhold	rettsforhold	+?
rettsanvendelse	oikeudenkäyttö
ressursplan	ressursplan	+?
ressursgruppe	ressursgruppe	+?
resolusjon	päätöslauselma
reproduksjon	reproduksjon	+?
repertoar	repertoar	+?
relevans	relevans	+?
rekvisisjon	rekvisisjon	+?
rekrutteringsstrategi	rekrutteringsstrategi	+?
rekruttere	rekrytoida
rekruttere	pestata
rehabiliteringstjeneste	rehabiliteringstjeneste	+?
rehabilitering	kuntoutus
rehabilitering	vieroitushoito
regjeringsparti	regjeringsparti	+?
regionkontor	regionkontor	+?
reduksjon	väheneminen
realfag	realfag	+?
rammevilkår	rammevilkår	+?
rammetilskudd	rammetilskudd	+?
rammebetingelse	rammebetingelse	+?
raid	raito
radiosending	radiolähetys
psykologi	psykologia
pst	pst	+?
prøveprosjekt	prøveprosjekt	+?
prøvedrift	prøvedrift	+?
prosjektplan	prosjektplan	+?
prosjektperiode	prosjektperiode	+?
prosjektmiddel	prosjektmiddel	+?
prosjektleder	prosjektleder	+?
promille	promille
programvareleverandør	programvareleverandør	+?
privatperson	yksityishenkilö
prise	prise	+?
primus	primus	+?
primærnæring	primærnæring	+?
prestisje	prestisje	+?
pressemelding	lehdistötiedote
premiss	premissi
praktisering	praktisering	+?
politikkutvikling	politikkutvikling	+?
politikkutforming	politikkutforming	+?
planlegger	suunnittelija
pdf-format	pdf-format	+?
påtale	moittia
pasientbehandling	pasientbehandling	+?
paraplyorganisasjon	kattojärjestö
pålegg	päällyste
pålegg	leikkele
overtakelse	overtakelse	+?
overgrep	oikeudenloukkaus
overgangsordning	overgangsordning	+?
or	leppä
opptaksreglement	opptaksreglement	+?
opplag	levikki
oppgradering	oppgradering	+?
oppfattelse	oppfattelse	+?
oppdragsbrev	oppdragsbrev	+?
oppdragelse	oppdragelse	+?
oppbygging	oppbygging	+?
operativsystem	käyttöjärjestelmä
omsorgstilbud	omsorgstilbud	+?
ombudsmann	oikeusasiamies
ombudsmann	asiamies
ombud	ombud	+?
nytteverdi	nytteverdi	+?
nyhetstilbud	nyhetstilbud	+?
nyhetssending	uutislähetys
norskfag	norskfag	+?
nordland	nordland	+?
nom	nom	+?
nødmelding	nødmelding	+?
nødløsning	nødløsning	+?
nettverksmøte	nettverksmøte	+?
nedgang	laskeuma
nasjonalstat	kansallisvaltio
mv	mv	+?
motstand	vastarinta
motstand	vastustaminen
motstand	vastustus
motivering	motivering	+?
motivasjon	motivaatio
motivasjon	into
morsmålsopplæring	morsmålsopplæring	+?
moment	momentti
mod	mod	+?
misk	misk	+?
minoritetsspråkspakt	minoritetsspråkspakt	+?
minoritetssituasjon	minoritetssituasjon	+?
minoritetsperspektiv	minoritetsperspektiv	+?
minoritetsbefolkning	minoritetsbefolkning	+?
minimumskrav	minimumskrav	+?
merutgift	lisäkustannus
merking	merking	+?
meglergruppe	meglergruppe	+?
media	media
masterutdanning	masterutdanning	+?
master	master	+?
massemedium	joukkotiedotusväline
markasame	markasame	+?
mandat	mandaatti
mandat	toimiala
måloppnåelse	måloppnåelse	+?
majoritetsbefolkning	valtaväestö
m.m	m.m	+?
lulesame	lulesame	+?
lovutkast	lovutkast	+?
lovlighetskontroll	lovlighetskontroll	+?
lovforslag	lakiehdotus
lokalkontor	lokalkontor	+?
lokalavis	paikallislehti
logo	logo
løft	nosto
løft	nousu
livskvalitet	elämänlaatu
lingvistikk	lingvistiikka
likeverd	likeverd	+?
likestilling	tasa-arvo
lekespråk	lekespråk	+?
legging	legging	+?
legetjeneste	legetjeneste	+?
lærerhøgskole	lærerhøgskole	+?
læremiddelsituasjon	læremiddelsituasjon	+?
læremiddelpedagogikk	læremiddelpedagogikk	+?
læremiddelforfatter	læremiddelforfatter	+?
læremateriell	læremateriell	+?
lærekraft	lærekraft	+?
kvalitetsvurdering	kvalitetsvurdering	+?
kvalifikasjon	pätevyys
kursavgift	kursavgift	+?
kunstnerorganisasjon	kunstnerorganisasjon	+?
kunstneravtale	kunstneravtale	+?
kunnskapsspråk	kunnskapsspråk	+?
kunnskapsoppbygging	kunnskapsoppbygging	+?
kunnskapsbase	tietopohja
kulturuttrykk	kulturuttrykk	+?
kulturtiltak	kulturtiltak	+?
kulturkunnskap	kulturkunnskap	+?
kulturbærer	kulturbærer	+?
kulturaktivitet	kulturaktivitet	+?
krave	kaulus
konvertere	konvertere	+?
kontantstøtte	kontantstøtte	+?
konsultasjonsmøte	konsultasjonsmøte	+?
konklusjon	lopputulos
konklusjon	johtopäätös
konklusjon	päätelmä
konklusjon	päättely
kompetansetiltak	kompetansetiltak	+?
kompetansestrategi	kompetansestrategi	+?
kompetansemiddel	kompetansemiddel	+?
kompetansemål	kompetansemål	+?
kompetanseheving	kompetanseheving	+?
kompetansebase	kompetansebase	+?
kompensasjon	kompensasjon	+?
komp	komp	+?
kommunikasjonssvikt	kommunikasjonssvikt	+?
kommunehelsetjeneste	kommunehelsetjeneste	+?
kommuneansatt	kommuneansatt	+?
knapphet	niukkuus
klagesak	klagesak	+?
klagerett	valitusoikeus
klageinstans	klageinstans	+?
kildinsamisk	kildinsamisk	+?
kapitel	kapitel	+?
kan	kan	+?
jurisdiksjon	jurisdiksjon	+?
jordmortjeneste	jordmortjeneste	+?
iverk	iverk	+?
it	it	+?
inuitspråk	inuitspråk	+?
internettside	internettside	+?
internet	internet	+?
intensjon	intensjon	+?
intelligens	älykkyys
inntrykk	vaikutelma
inntak	saanti
innslag	innslag	+?
innrykk	innrykk	+?
innleder	innleder	+?
innkalling	innkalling	+?
innflytelse	vaikutusvalta
innblikk	innblikk	+?
innad	innad	+?
informasjonsteknologi	informasjonsteknologi	+?
informasjonssystem	informasjonssystem	+?
informasjonskanal	informasjonskanal	+?
informasjonsarbeid	informasjonsarbeid	+?
incitament	incitament	+?
il	il	+?
iht	iht	+?
igangsetting	igangsetting	+?
høyskolenivå	høyskolenivå	+?
hovedvekt	hovedvekt	+?
hovedutfordring	hovedutfordring	+?
hovedtema	hovedtema	+?
hovedkvarter	päämaja
hovedkvarter	pääesikunta
hovedansvar	hovedansvar	+?
hovedaktivitet	päätoiminta
høringsrett	høringsrett	+?
høring	høring	+?
høgskolenivå	høgskolenivå	+?
hjelpetilbud	hjelpetilbud	+?
helsevesen	terveydenhuolto
helsetilsyn	helsetilsyn	+?
helsetilbud	helsetilbud	+?
helsesektor	helsesektor	+?
helserett	helserett	+?
helseregion	helseregion	+?
helsereform	helsereform	+?
helseområde	helseområde	+?
helseinformasjon	helseinformasjon	+?
helsearbeid	helsearbeid	+?
heft	heft	+?
handlingsplanperiode	handlingsplanperiode	+?
halvtime	puolitunti
habilitering	habilitering	+?
habilitere	habilitere	+?
gudstjenestetradisjon	gudstjenestetradisjon	+?
grunnskolenivå	grunnskolenivå	+?
grunnskolelærer	grunnskolelærer	+?
grunnskoleelev	grunnskoleelev	+?
grunnforskning	grunnforskning	+?
grønlender	grønlender	+?
grensesamarbeid	grensesamarbeid	+?
fysioterapitjeneste	fysioterapitjeneste	+?
fylkesting	maakuntakäräjät
fylkesgrense	fylkesgrense	+?
fylkesbibliotek	fylkesbibliotek	+?
fritidstilbud	fritidstilbud	+?
fritidsinteresse	fritidsinteresse	+?
fritidsarena	fritidsarena	+?
frigjøring	frigjøring	+?
framstilling	framstilling	+?
fosterhjem	fosterhjem	+?
forvaring	säilö
forvaltningsskikk	forvaltningsskikk	+?
forvaltningsnivå	forvaltningsnivå	+?
fortrinnsrett	fortrinnsrett	+?
forsøksordning	forsøksordning	+?
forsøk	yritys
førskolelærerutdanning	førskolelærerutdanning	+?
førskole	esikoulu
forskningsverden	forskningsverden	+?
forskningsavdeling	forskningsavdeling	+?
forsakelse	forsakelse	+?
fornorskningspolitikk	fornorskningspolitikk	+?
fornorskingspolitikk	fornorskingspolitikk	+?
formulering	formulering	+?
formidling	välitys
formidling	levittäminen
format	formaatti
forebygging	ehkäiseminen
fonetikk	fonetikk	+?
fleksibilitet	joustavuus
fjernsynssending	televisiolähetys
filmproduksjon	filmproduksjon	+?
filmpolitikk	filmpolitikk	+?
feilbehandling	feilbehandling	+?
fall	kaatuminen
fall	pudotus
fall	putoaminen
fall	putous
faktum	tosiasia
faktum	fakta
faks	faks	+?
fagutdanning	fagutdanning	+?
fagterminologi	fagterminologi	+?
eventyrstund	eventyrstund	+?
ev	ev	+?
etterspørsel	kysyntä
etterlevelse	etterlevelse	+?
enkeltindivid	enkeltindivid	+?
enhet	ykseys
enhet	yksikkö
enhet	yhtenäisyys
engasjement	kiinnostus
ending	ending	+?
enaresamisk	enaresamisk	+?
ekspertkomité	ekspertkomité	+?
eksemplar	eksemplar	+?
eierstyring	eierstyring	+?
egnethet	egnethet	+?
egennavn	erisnimi
effekt	tehoste
effekt	teho
effekt	efekti
ealphabet	ealphabet	+?
driver	ajuri
driftstilskudd	driftstilskudd	+?
driftsorganisasjon	driftsorganisasjon	+?
domstollov	domstollov	+?
dommeravhør	dommeravhør	+?
doktorgradsnivå	doktorgradsnivå	+?
døgntilbud	døgntilbud	+?
distriktskontor	distriktskontor	+?
diskusjon	keskustelu
dialogpartner	dialogpartner	+?
design	design
dekning	kate
definisjon	määritelmä
definisjon	määrittely
dataprogram	tietokoneohjelma
databehandling	databehandling	+?
database	tietokanta
dagtid	dagtid	+?
dagligliv	dagligliv	+?
charter	peruskirja
ca	ca	+?
bytting	bytting	+?
bykommune	bykommune	+?
bygging	bygging	+?
budsjettvedtak	budsjettvedtak	+?
budsjettarbeid	budsjettarbeid	+?
bruksområde	bruksområde	+?
bransje	ala
brannvesen	palokunta
brannvesen	palotoimi
bosettingsområde	bosettingsområde	+?
bokhandler	bokhandler	+?
bistand	bistand	+?
bispedømme	hiippakunta
binding	sidonta
binding	sidos
bibliotekspørsmål	bibliotekspørsmål	+?
bibeltekst	bibeltekst	+?
behandlingsnivå	behandlingsnivå	+?
behandlingsinstitusjon	behandlingsinstitusjon	+?
behandler	behandler	+?
begynner	begynner	+?
begrensing	begrensing	+?
barnevernstjeneste	barnevernstjeneste	+?
barnevernsinstitusjon	barnevernsinstitusjon	+?
barnevernlov	barnevernlov	+?
barnetrinn	barnetrinn	+?
barneombud	barneombud	+?
barnekonvensjon	barnekonvensjon	+?
barnehagepolitikk	barnehagepolitikk	+?
barnehagepersonale	barnehagepersonale	+?
barnehageområde	barnehageområde	+?
barnehagemyndighet	barnehagemyndighet	+?
barnehagebarn	barnehagebarn	+?
bakgrunnskunnskap	bakgrunnskunnskap	+?
avsetning	menekki
avkastning	tuotto
avistilbud	avistilbud	+?
avhør	avhør	+?
avd	avd	+?
autonomi	autonomia
atlas	kartasto
årti	årti	+?
årsverk	årsverk	+?
årsakssammenheng	årsakssammenheng	+?
arbeidsbyrde	arbeidsbyrde	+?
ansvarsforhold	ansvarsforhold	+?
ansvarsfordeling	ansvarsfordeling	+?
anstalt	anstalt	+?
ansettelse	ansettelse	+?
anrop	anrop	+?
annonsering	ilmoittaminen
ange	ange	+?
and	ankka
and	sorsa
amatørteatervirksomhet	amatørteatervirksomhet	+?
allmennlærer	allmennlærer	+?
allmennhet	yleisö
alfa	alfa	+?
alderspensjon	vanhuuseläke
Ot.prp. nr	Ot.prp. nr	+?
ILO-konvensjon	ILO-konvensjon	+?
Ealphabet	Ealphabet	+?
Divvun-prosjekt	Divvun-prosjekt	+?
